3 13 31
###############################
#p   **b**    *   2           #
# #b# # # #*#1# # # # # #*# # #
#*     ** * *  *   * ** 1 *   #
# # # #*# # # # # # # # # # # #
#        *   **    *   2*     #
# # # # # # # # # # # # # #*# #
#    *     x        *    **  2#
# #*# # #*#*#*#*# # #1# # #*# #
#*   **fs   *** * x **        #
#*# # # # # # # # # # #*# # #*#
# *    * **    * b**   *  2   #
###############################

# #b# # # #*#2# # # # # #*# # #