2 13 31
###############################
#p    *1  *   2  ** * *      *#
# # # # #*# # #*# # # # # #*# #
#   *bf        *   * *x* *    #
# #*# # # # # # #b#1# # # # #*#
#         s*     **      *  **#
# # #*# # # # # #*#*#*#*# # # #
#    * * *** **  2   *    **  #
# # # # #*# # # # # # #*# #*# #
#   ****         *2           #
# # # # # # # # # #*# # # # #*#
# b * *2  *    1        s     #
###############################