###############################
#    1*   *      ** * *      *#
# # # # #*# # #*# # # # # #*# #
#   *          *   * * * *    #
# #*# # # # # # # # # # # # #*#
#          *     **      *  **#
# # #*# # # # # #*#*#*#*# # # #
#    * * *** **      *    **  #
# # # # #*# # # # # # #*# #*# #
#   ****         *            #
# # # # # # # # # #*# # # # #*#
#   * *   *                   #
###############################