###############################
#p   **b**    *               #
# #b# # # #*#1# # # # # #*# # #
#*     ** * *  *   * **   *   #
# # # #*# # # # # # # # # # # #
#        *   **    *    *     #
# # # # # # # # # # # # # #*# #
#    *              *    **   #
# #*# # #*#*#*#*# # #1# # #*# #
#*   **     *** *   **        #
#*# # # # # # # # # # #*# # #*#
# *    * **    *  **   *      #
###############################